NO ./textures/east.png
SO ./textures/north.png
WE ./textures/south.png        
EA ./textures/west.png

F 225,127,80
C 245,222,0

        1111111111111111111111111
        1000000000110000000000001
        1011000001110000000000001
        1001000000000000000000011
11111111101100000111000000N000001
100000000011000001110111101111111
11110111111111011100000000001
11110111111111011101010010001
11000000110101011100000010001
10000000000000000000000010001
10000000000000001101010010001
110000011101010111110111 100111
11110111 1110101 101111010001
11111111 1111111 111111111111

