                       NO                    ./textures/east.png



SO ./textures/north.png
WE ./textures/south.png        

EA ./textures/west.png

F 44,117,255


C 0,0,113




11111111111
10000S00001
10000000001
10000000001
10000000001
10000000001
10000000001
10000000001
10000000001
10000000001
10000000001
11111111111